1111111111111111111111
100C1P0000000000000001
1011100000001100111001
10000000C0001C001110C1
110C011000000000000001
10000010000010C0000001
101110000C0010000C0001
100C100111111000000001
1000100001000000111001
101000110100C00111E001
1C10011C000000001110C1
1111111111111111111111