11111
10PC1
1C101
1E0C1
11111
