11111
1P0C1
11101
111E1
11111
